NO ./texture/no.xpm
SO ./texture/so.xpm
WE ./texture/we.xpm
EA ./texture/ea.xpm

F 220,100,0
C 225,30,0

                 11111111111111111111
11111111111111111111
10000000000000000001
10000000N00000000001
10000000000000000001
10000000000000000001
100001111110000000001
1111111   1111111111111